111111111111111111111111111111111
110000000000000E00000C00000000001
10100101001000F010100100000010101
101001001010101000100100000010111
1P0000000C00C000000000C00000000C1
111111111111111111111111111111111
